12 4 5 5 5 5 5 5 5 4 4 5 5 5 5 5 5 4 5 5 5 5 5 5 5 5 5 6 12 6
10 8 5 5 5 5 5 5 6 10 10 13 5 5 5 5 5 0 5 5 5 5 5 5 5 5 6 10 11 10 
10 9 5 6 13 5 5 5 10 10 9 5 5 5 5 5 6 10 12 5 5 5 5 5 5 6 10 8 5 3
8 5 7 10 12 5 6 5 10 9 5 5 5 5 5 6 10 10 10 14 12 5 5 5 6 10 10 8 5 6
8 5 7 10 10 14 10 10 9 5 5 5 5 5 6 10 10 10 10 10 8 5 5 6 10 10 10 9 7 10
10 12 5 3 10 10 10 9 10 10 10 10 10 6 11 10 10 10 10 10 10 14 13 3 10 10 8 5 5 3
11 10 13 5 3 10 9 6 12 5 5 5 5 1 5 3 10 10 10 10 10 8 5 5 3 10 10 12 5 6
14 8 5 5 5 2 14 10 10 12 5 5 5 5 5 5 3 10 10 10 10 10 12 5 5 3 10 9 7 10
10 9 5 5 6 10 10 10 10 9 5 5 5 5 5 5 5 3 10 10 10 10 10 12 5 5 1 5 5 3
10 13 5 5 2 10 10 10 8 5 5 5 5 5 5 5 5 5 3 10 10 10 10 10 13 5 5 5 5 6
8 5 5 8 10 11 10 10 10 12 5 4 5 5 5 5 5 5 5 3 10 10 10 9 5 5 5 5 5 3
9 5 4 5 1 5 1 3 9 3 14 11 12 5 5 5 5 5 5 5 3 10 10 13 5 5 5 5 5 6
12 6 10 13 5 5 5 5 5 5 1 5 2 12 5 5 5 5 5 5 7 10 8 5 5 5 5 5 5 2
10 10 9 5 5 5 5 5 5 5 5 5 3 9 5 5 5 5 5 5 5 3 10 12 5 5 5 5 6 10 
10 9 5 5 5 5 5 5 4 5 5 5 4 5 5 5 5 5 5 5 5 5 3 11 12 5 5 6 10 10
8 5 5 5 5 5 5 7 10 13 5 6 10 14 14 12 5 5 5 5 5 6 12 5 3 12 5 1 10 10
10 13 5 4 5 5 5 5 1 5 5 3 10 10 8 3 12 5 5 5 7 10 10 13 6 10 12 5 5 3
10 12 6 10 12 5 5 5 5 5 5 5 3 10 10 13 1 5 5 5 5 3 9 5 3 10 10 12 4 2
10 10 10 10 10 12 5 4 5 5 5 5 5 3 9 5 5 5 4 4 5 5 5 5 5 3 11 10 10 10
10 10 10 10 10 10 14 10 12 5 4 6 12 5 5 4 6 14 11 8 5 5 5 5 5 5 5 3 10 10 
10 10 10 10 10 10 10 10 10 14 10 10 10 12 6 11 9 1 6 10 12 5 5 5 5 5 5 5 3 10
9 3 9 3 10 10 10 10 10 10 11 10 8 2 8 5 5 7 10 10 8 5 5 5 5 5 5 5 7 10
12 5 5 5 3 10 10 11 10 9 5 3 11 9 2 13 5 6 10 10 9 5 5 4 5 6 12 5 5 3
8 5 5 5 5 1 1 5 1 5 5 5 5 7 9 5 5 3 9 0 5 5 6 10 14 10 10 12 4 6
9 5 5 5 5 5 4 5 5 5 5 5 5 5 5 5 5 5 5 3 12 6 10 10 10 10 10 10 11 10
12 5 5 5 5 7 10 13 5 5 5 5 6 13 5 5 5 5 5 5 2 11 10 9 1 3 10 8 5 2
10 13 5 5 5 5 0 5 5 5 5 7 10 12 5 5 5 6 14 14 9 5 1 5 5 6 10 10 14 10
8 5 5 5 5 6 10 13 5 5 5 5 2 8 5 5 6 9 1 1 4 5 4 5 6 10 10 9 4 2
10 13 5 4 7 10 9 5 5 5 5 5 2 8 5 7 9 5 5 7 8 7 10 13 3 10 8 5 5 3
9 5 5 1 13 1 5 5 5 5 5 5 3 9 5 5 5 5 5 7 9 5 1 5 5 3 9 5 5 7